EEEEEEEEEEEEEEEEEEE
WWWWWWWW111WWWWWWWW
EEE1E1E2EEE2E1E1EEE
WWWWWWWWWWWWWWWWWWW
EE3EEE3E444EEE3EE43
WWWWWWWWEEEWWWWWWWW
EEE43EEE443EEEE3E3E
