ETWEEEEEEE
WWWEEEEWWW
EEEWWWEWTW
WWEW1WEWWW
TWEWWWEEEE
WWEEEEEEEE
EEEEEEEEEE
EEWWWWWEEE
EEWETEWEEE
