EWEEEWE1E
4W3W2W1EE
4W3W2W1EE
4W3W2W1EE
4W3W2W1EE
4W3W2W1EE
EEEWEEEWE
