EEEE1122E
EEEEEEE23
EEEEEEEEE
EEEEEEEEE
1EEEEEEEE
1EEEEEEEE
4EEEEEEEE
44EEEEEEE
E4EEEEEEE
