EWWEE3E1E
EEWEWWWWE
WEWEEEEEE
EEWEWWWWE
EWEEEEEEE
EEWWWEWWW
E1EEE1EEE
