EE1EWEEEEEEEEEEE4TE
E1T1WEEE2EEEEEEE444
WWWWWEEEEE3EEEEEEEE
EEE2EEEEEEEEEEEEEEE
EEEEE2EEE2EEEEEEEEE
E3TEEEEEEEEEEE3EEEE
EEEEEEEEEEEEEEEEEEE
