EEEEEEEEEEEEEEE
E111EEEEEEE444E
E1T1EEEEEEE4T4E
EEEEEEEEEEEEEEE
EEEEEEEEEEEEEEE
EEEEEEEEEEEEEEE
EEEEEEEEEEEEEEE
EEEEEEEEEEEEEEE
E333EEEEEEE222E
E3T3EEEEEEE2T2E
EEEEEEEEEEEEEEE
