E1E3EEEEEEEEEEEEEE3E
EEEEEEEEEEE1EE4EEEEE
1E4EEEEEEEEEEEEEEEEE
EEEEEEEEEEEEEEEE1EEE
EE1EE3EEEE1EEEEEEEEE
EEEEEEEEEEEEEEEEEE3E
EEEEEEEE1EEEEEEEEEEE
E1EEEEEEEEEEEEE4EEEE
EEEEEEEEEEE3EEEEEEE3
E3EEEEE1EEEEEEEE1EEE
4EEEEEEEEEEEEE4EEEEE
EEEEEEEEEEEE1EEEEEEE
E1EEEEEE3EEEEEEE1EE3
EEEEEEEEEEEEEEEEEEEE
EE3EEEEEEEEEEEEEEEEE
EEEEE1EEEEEE4E1EEEEE
1EEEEEEEEEEEEEEEEEEE
EEEEEEEE1EE3EEEEEE1E
E31EEEEEEEEE1EEEEEEE
E4EEEE3EEEEEEEEE4E3E
