ETWEEEEEEEEEEEWTE
WWWEEEEEEEEEEEWWW
EEEEEEEEEEEEEEEEE
EEEEEEEEEEEEEEEEE
EEEEEEEEEEEEEEEEE
WWWWEEEEEEEEEEWWW
ET1WEEEEEEEEEEWTE
