EEEE1112E
EEEEEEE2E
EEEEEEEEE
EEEEEEEEE
1EEEEEEEE
1EEEEEEEE
1EEEEEEEE
23EEEEEEE
EEEEEEEEE