EEEEEEEEEEEEEEE
E422EEEEEEEEEEE
E4T2EEEEEEEEEEE
E4EEEEEEEEEEEEE
EEEEEEEEEEEEEEE
EEEEEEEEEEEEEEE
EEEEEEEEEEEEEEE
EEEEEEEEEEEEEEE
EEEEEEEEEEE311E
EEEEEEEEEEE3T1E
EEEEEEEEEEE3EEE