E1WEEEEEEEEEEEEEW2E
1TWEEEEEEEEEEEEEWT2
WWWEEWWWWEEEEEEEWWW
EEEEEW3TWEEEEEEEEEE
WWWEEW43WEEEEEEEWWW
3TWEEWWWWEEEEEEEWT2
E3WEEEEEEEEEEEEEW2E