ETEEEEEEEEEEEEEEEEE
T2222222EEEEEEEEEEE
EE2EEEE2EEEEEEEEEEE
EE2EEEE2EEEEEWWWWWW
EE2EEEE2222EEWT111T
EE2EEEEEEE2EEWT111T
EE222222222EEWWWWWE