EEEEWE3EEEEEEEE
EEEEWEEEEE2EEEE
EEETWEEEEEEEEEE
WWWWWEEEEEEEEEE
EE3EEETEEEEE11E
EEEEEEEEEEEEEEE