E1TEE1EE1EEEEEEE
11TEEEEWWWWWE111
111EEEEWT1TWEEEE
EEEEEEEWWWWWEEEE
E111EE111EEEEEEE
EEEEEEEEEEEEEEEE
EEEEEEWWWWWEEEEE
EEEEEEWT44WEEEEE
EEEEEEWWWWWEEEEE
EEEEEEEWWWWWEEEE
EEEEEEEWEEEWEEEE
EEEEEEEWWWWWEEEE
EEEEEEEEEEEEEEEE
EEEEEEEWWWWWEEEE
EEEEEEEWT2TWEEEE
EEEEEEEWWWWWEEEE

