EW1111111111111111WE
EW1111111111111111WE
EW1111111111111111WE
EW1111111111111111WE
EW1111111111111111WE
EW1111111111111111WE
EW1111111111111111WE
EW1111111111111111WE
EW1111111111111111WE
EW1111111111111111WE
EW1111111111111111WE
EW1111111111111111WE
EW1111111111111111WE
EW1111111111111111WE
EW1111111111111111WE
EW1111111111111111WE
EW1111111111111111WE
EW1111111111111111WE
EWWWWWWWWWWWWWWWWWWE
EEEEEEEEEEEEEEEEEE1E